33 33
WWWWWWWWWWWWWWWWWWWWWWWWWWWWWWWWW
WSWLLLLLWLLLLLWLLLLLWLLLLLWLLLLLW
WLLLWLWLWLWWWLLLWLWLLLWLWLLLWWLLW
WLWLWLLLWLLLWLLLLLLLWLLLLLLLWLLLW
WWWWWLWLWWWLWWWWWWWWWLWLWWWWWLWLW
WLLLWLWLLLLLLLLLLLWLLLWWWLLLWLLLW
WLWLWWWLWWWLWLWLWLWLWWWLWWWLWWLLW
WLWLWLLLWLLLLLWLLLLLWLLLWLLLLWLLW
WLWWWWWLWLWWWWWLWWLWWWLWWLWWWWWWW
WLLLLLWLLLLLLLLLWLLLWLLLLLWLWLLLW
WLWLWWWLWWWLWLWWWLWLLLWLWWWWWWLLW
WLWLWLLLWLLLWLLLLLWLLLWWWLLLLLLLW
WLWWWLWLWLWWWLWWWLWWWWWLWWWWWLWWW
WLWLLLWWWLLLLLWLWLLLLLLLLLWLWLLLW
WLLLWWWLWLWLWLWLWWWLWWLWWLWLWWWLW
WLLLWLLLLLLLWLLLLLLLWLLLLLLLLLLLW
WWWWWWWWWWWWWWWWWWLWWWWWLWWWLWWWW
WLWLWLLLWLWLLLLLWLLLLLLLLLWLLLLLW
WLWLLLLLWWWLWLLLWLWLWLWLWWWLWWLLW
WLWLLLWLWLWLLLWLWLLLWLLLWLWLLLLLW
WLWLWLWWWWWWWWWWWLWWWLWWWWWWWWWWW
WLLLWLLLLLLLWLLLWLWLLLLLWLLLLLLLW
WWWLLLLWWWWLWLLWWLLLWLWLWWWLWWLLW
WLLLWLLLWLLLLLLLWLLLWLLLLLLLLWLLW
WLWWWWLWWLWWWWWWWWLWWWWWWLWLWWWLW
WLWLLWLLWLLWLLLLWLLLWLWLLLWLLLWLW
WLWLWWWLWLWWWLWLWLWLLLLLWLWLWWWLW
WLLLWLLLWLLLWLLLWWWLLLWLWLWLWLLLW
WWWWWLLWWLWLWWWWWLWWWWWLWWWWWLWLW
WLWLLLLLWLLLLLLLWLLLWLLLWLLLLLLLW
WLWWWLWLLLLWWLWLWWWWWLLWWLWLWWWLW
WLWLLLLLWLLLLLLLLLLLWLLLLLWLLLLEW
WWWWWWWWWWWWWWWWWWWWWWWWWWWWWWWWW